
NO ./src_textures/no_textures.xpm
SO ./src_textures/so_textures.xpm

WE ./src_textures/we_textures.xpm
EA ./src_textures/ea_textures.xpm
F 200,20,8
C 0,45,100

    111111111111111111111     111111111      111111111111111111111111111111
    111111111111100000001111111000000011111111000000000000000D0000000000111
    100001010110000000000000000000000000000000000000000000001100000000001
    11111001001000111000000000000000000000000000000000000000011111111111111
111 100000000000011000000000000000000000000000000000000000000000000000111
1111100000000011111111111111111111D1111111111111111111111111111111111000111
  100000000000001             111000000000001           10000000D0000000001
11111000000000111           11110000000000111         111111111110000000111
101110000001111               1100000010001           1000000000000000001
111000000001               1111111110000001        111100000000000000000111
  1010000001             111000000000001111        1000000000000000001111
1111100001111             11100000000001         1111100000000000000000111
100010000011            1110000000000011          1000000000000000001111
1D1W10000001             111000000000001          110000000000000000011111
1011100001111             111000000000011111111111111111000000000000000001
10000000001             11100000000000000000000000000000000000000000011111
111111111111            111111111111111111111111111111111111111111111111
 1  1  1  1


