C 200,20,8
F 0,45,100

NO ./textures/north.xpm
SO ./textures/south.xpm
WE ./textures/west.xpm
EA ./textures/east.xpm

11111111111111111111
10000000000000000001
10000000000000000001
10000000000000000001
10000000000000000111
100000000000000001
10000000000000000111
10000000000000000001
10000000000000000001
10000000000000000001
10000000000011100001
10000000000020200001
10000000000011100001
10000000000000000001
10000000000000000001
10000000000000000001
10000000000000000001
100000000N0000000001
10000000000000000001
11111111111111111111