C 200,20,8
F 0,45,100

NO ./textures/north.xpm
SO ./textures/south.xpm
WE ./textures/west.xpm
EA ./textures/east.xpm

1111111111
10N0000001
1000000001
1111111111