NO ./textures/mossy.xpm
SO ./textures/eagle.xpm
WE ./textures/redbrick.xpm
EA ./textures/wood.xpm

F  11,122,126
C  10,183,183

1111111
1W1
1111111